UCS
40
11,39
27,39
8, 2, 6, 3, 2, 4, 3, 2, 7, 3, 5, 8, 2, 6, 3, 2, 4, 3, 2, 4, 3, -1, 8, 2, 6, 3, 2, 4, 3, 2, 2, 4, 7, 2, 4, 5, 9, 9, 5, 2
8, 2, 6, 3, 2, 4, 3, 2, 7, 3, 5, 8, 2, 6, 3, 2, 4, 3, 2, 4, 3, -1, 8, 2, 6, 3, 2, 4, 3, 2, 2, 4, 7, 2, 4, 5, 9, 9, 5, 2
8, 2, 6, 3, 2, 4, 3, 2, 7, 3, 4, 5, 9, 4, 5, 9, 4, 3, 2, 4, 3, -1, 2, 5, 9, 4, 5, 9, 4, 5, 9, 4, 7, 2, 4, 5, 9, 9, 5, 2
8, 2, 6, 3, 2, 4, 3, 2, 7, 3, 5, 4, 3, 4, 3, 4, 4, 5, 2, 1, 2, -1, 4, 2, 4, 7, 4, 7, 4, 7, 2, 4, 7, 2, 4, 5, 9, 9, 5, 2
8, 2, 6, 3, 2, 4, 3, 2, 7, 3, 5, 4, 3, 4, 3, 4, 7, 1, 9, 9, 9, -1, 5, 6, 9, 3, 4, 7, 4, 7, 2, 4, 7, 2, 4, 5, 9, 9, 5, 2
8, 2, 6, 3, 2, 4, 3, 2, 7, 3, 5, 4, 3, 4, 3, 2, 1, 6, 9, 9, 8, -1, -1, 4, 9, 2, 4, 7, 4, 7, 2, 4, 7, 2, 4, 5, 9, 9, 5, 2
8, 2, 6, 3, 2, 4, 3, 2, 7, 3, 5, 4, 3, 4, 3, 5, 2, 8, 9, 9, 9, -1, -1, 3, 9, 3, 9, 7, 4, 7, 2, 4, 7, 2, 4, 5, 9, 9, 5, 2
8, 2, 6, 3, 2, 4, 3, 2, 7, 3, 5, 4, 3, 4, 3, 2, 1, 6, 6, -1, -1, -1, 1, 5, 2, 3, 9, 7, 4, 7, 2, 4, 7, 2, 4, 5, 9, 9, 5, 2
8, 2, 6, 3, 2, 4, 3, 2, 7, 3, 5, 4, 3, 4, 3, 2, 1, 6, 6, 6, -1, 6, 2, 5, 2, 4, 9, 7, 4, 7, 2, 4, 7, 2, 4, 5, 9, 9, 5, 2
8, 2, 6, 3, 2, 4, 3, 2, 7, 3, 5, 4, 3, 4, 3, 3, 2, 6, 6, 6, -1, 6, 2, 4, 3, 4, 8, 7, 4, 7, 2, 4, 7, 2, 4, 5, 9, 9, 5, 2
8, 2, 6, 3, 2, 4, 3, 2, 7, 3, 5, 4, 3, 4, 3, 1, 1, 6, 6, 6, -1, 6, 1, 6, 5, 3, 9, 7, 4, 7, 2, 4, 7, 2, 4, 5, 9, 9, 5, 2
8, 2, 6, 3, 2, 4, 3, 2, 7, 3, 5, 4, 3, 4, 3, 2, 1, 6, 6, 9, -1, 6, 1, 2, 2, 3, 9, 7, 4, 7, 2, 4, 7, 2, 4, 5, 9, 9, 5, 2
8, 2, 6, 3, 2, 4, 3, 2, 7, 3, 5, 4, 3, 4, 3, 2, 1, 6, 6, -1, -1, 6, 2, 6, 2, 4, 9, 7, 4, 7, 2, 4, 7, 2, 4, 5, 9, 9, 5, 2
8, 2, 6, 3, 2, 4, 3, 2, 7, 3, 5, 4, 3, 4, 3, 6, 2, 6, 6, -1, 6, 6, 3, 7, 3, 4, 8, 7, 4, 7, 2, 4, 7, 2, 4, 5, 9, 9, 5, 2
8, 2, 6, 3, 2, 4, 3, 2, 7, 3, 5, 4, 3, 4, 3, 3, 1, 6, 6, -1, 6, 4, 4, 6, 5, 3, 7, 7, 4, 7, 2, 4, 7, 2, 4, 5, 9, 9, 5, 2
8, 2, 6, 3, 2, 4, 3, 2, 7, 3, 5, 4, 3, 4, 3, 5, 3, 6, 6, -1, 9, -1, 2, 3, 2, 3, 8, 7, 4, 7, 2, 4, 7, 2, 4, 5, 9, 9, 5, 2
8, 2, 6, 3, 2, 4, 3, 2, 7, 3, 5, 4, 3, 4, 3, 7, 2, 6, 6, -1, -1, 6, 1, 2, 2, 4, 9, 7, 4, 7, 2, 4, 7, 2, 4, 5, 9, 9, 5, 2
8, 2, 6, 3, 2, 4, 3, 2, 7, 3, 5, 4, 3, 4, 3, 4, 1, 6, 6, 9, -1, -1, 1, 3, 3, 4, 8, 7, 4, 7, 2, 4, 7, 2, 4, 5, 9, 9, 5, 2
8, 2, 6, 3, 2, 4, 3, 2, 7, 3, 5, 4, 3, 4, 3, 3, 2, 6, 9, 9, -1, -1, 2, 5, 5, 3, 7, 7, 4, 7, 2, 4, 7, 2, 4, 5, 9, 9, 5, 2
8, 2, 6, 3, 2, 4, 3, 2, 7, 3, 5, 4, 3, 4, 3, 2, 1, 6, 6, 9, -1, -1, 1, 3, 2, 3, 6, 7, 4, 7, 2, 4, 7, 2, 4, 5, 9, 9, 5, 2
8, 2, 6, 3, 2, 4, 3, 2, 7, 3, 5, 4, 3, 4, 3, 5, 2, 6, 6, 9, -1, -1, 1, 2, 2, 4, 7, 7, 4, 7, 2, 4, 7, 2, 4, 5, 9, 9, 5, 2
8, 2, 6, 3, 2, 4, 3, 2, 7, 3, 5, 4, 3, 4, 3, 6, 3, 9, 9, -1, -1, 6, 2, 3, 3, 4, 8, 7, 4, 7, 2, 4, 7, 2, 4, 5, 9, 9, 5, 2
8, 2, 6, 3, 2, 4, 3, 2, 7, 3, 5, 4, 3, 4, 3, 3, 1, 6, 9, -1, -1, -1, 2, 6, 5, 3, 9, 7, 4, 7, 2, 4, 7, 2, 4, 5, 9, 9, 5, 2
8, 2, 6, 3, 2, 4, 3, 2, 7, 3, 5, 4, 3, 4, 3, 2, 1, 6, 6, 9, 9, -1, 1, 3, 2, 3, 8, 7, 4, 7, 2, 4, 7, 2, 4, 5, 9, 9, 5, 2
8, 2, 6, 3, 2, 4, 3, 2, 7, 3, 5, 4, 3, 4, 3, 7, 2, 6, 6, 8, 9, -1, 2, 4, 2, 4, 9, 7, 4, 7, 2, 4, 7, 2, 4, 5, 9, 9, 5, 2
8, 2, 6, 3, 2, 4, 3, 2, 7, 3, 5, 4, 3, 4, 3, 4, 1, 6, 6, 9, 9, -1, 2, 3, 3, 4, 8, 7, 4, 7, 2, 4, 7, 2, 4, 5, 9, 9, 5, 2
8, 2, 6, 3, 2, 4, 3, 2, 7, 3, 5, 4, 3, 4, 3, 3, 2, 6, 6, 9, 6, -1, 1, 5, 5, 3, 7, 7, 4, 7, 2, 4, 7, 2, 4, 5, 9, 9, 5, 2
8, 2, 6, 3, 2, 4, 3, 2, 7, 3, 5, 4, 3, 4, 3, 2, 1, 6, 6, 8, -1, -1, 2, 3, 2, 3, 6, 7, 4, 7, 2, 4, 7, 2, 4, 5, 9, 9, 5, 2
8, 2, 6, 3, 2, 4, 3, 2, 7, 3, 5, 4, 3, 4, 6, 5, 1, 6, 6, 9, -1, -1, 1, 2, 2, 4, 1, 7, 4, 7, 2, 4, 7, 2, 4, 5, 9, 9, 5, 2
8, 2, 6, 3, 2, 4, 3, 2, 7, 3, 5, 4, 3, 4, 6, 2, 1, 6, 6, 6, -1, -1, 1, 3, 3, 4, 1, 7, 4, 7, 2, 4, 7, 2, 4, 5, 9, 9, 5, 2
8, 2, 6, 3, 2, 4, 3, 2, 7, 3, 5, 2, 2, 4, 1, 6, 6, 6, 6, 6, -1, -1, 6, 1, 2, 5, 4, 2, 5, 4, 2, 4, 7, 2, 4, 5, 9, 9, 5, 2
8, 2, 6, 3, 2, 4, 3, 2, 7, 3, 5, 2, 3, 2, 6, 6, 6, 6, 6, -1, -1, 6, 6, 6, 6, 1, 2, 2, 5, 4, 2, 4, 7, 2, 4, 5, 9, 9, 5, 2
8, 2, 6, 3, 2, 4, 3, 2, 7, 3, 5, 4, 1, 6, 6, 6, 6, 6, -1, -1, 6, 6, 6, 6, 6, 6, 6, 1, 3, 3, 2, 4, 7, 2, 4, 5, 9, 9, 5, 2
8, 2, 6, 3, 2, 4, 3, 2, 7, 3, 5, 1, 6, 6, 6, 6, 6, -1, -1, 6, 6, 6, 6, 6, 6, 6, 6, 2, 4, 6, 2, 4, 7, 2, 4, 5, 9, 9, 5, 2
8, 2, 6, 3, 2, 4, 3, 2, 7, 3, 5, 2, 6, 6, 6, 6, 6, 6, -1, -1, 6, 6, 6, 6, 6, 6, 6, 1, 5, 6, 2, 4, 7, 2, 4, 5, 9, 9, 5, 2
8, 2, 6, 3, 2, 4, 3, 2, 7, 3, 5, 1, 6, 6, 6, 6, 6, 6, 6, -1, 6, 6, 6, 6, 6, 6, 6, 2, 6, 6, 2, 4, 7, 2, 4, 5, 9, 9, 5, 2
8, 2, 6, 3, 2, 4, 3, 2, 7, 3, 5, 2, 6, 6, 6, 6, 6, 6, 6, -1, 6, 6, 6, 6, 6, 6, 6, 3, 7, 6, 2, 4, 7, 2, 4, 5, 9, 9, 5, 2
8, 2, 6, 3, 2, 4, 3, 2, 7, 3, 5, 1, 6, 6, 6, 6, -1, -1, -1, -1, 6, 6, 6, 6, 6, 6, 6, 2, 8, 6, 2, 4, 7, 2, 4, 5, 9, 9, 5, 2
8, 2, 6, 3, 2, 4, 3, 2, 7, 3, 5, 2, 6, 6, 6, 6, -1, -1, 6, 6, 6, 6, 6, 6, 6, 6, 6, 1, 7, 6, 2, 4, 7, 2, 4, 5, 9, 9, 5, 2
8, 2, 6, 3, 2, 4, 3, 2, 7, 3, 5, 1, 6, 6, 6, 6, 6, -1, 6, 6, 6, 6, 6, 6, 6, 6, 6, 3, 6, 6, 2, 4, 7, 2, 4, 5, 9, 9, 5, 2
