biastar
30
3,3
26,3
-1, -1, -1, -1, -1, -1, -1, -1, -1, -1, -1, -1, -1, -1, -1, -1, -1, -1, -1, -1, -1, -1, -1, -1, -1, -1, -1, -1, -1, -1
-1, 2, 2, 2, 4, 9, 3, 1, 9, 6, 2, 7, 9, 6, 8, 3, 8, 9, 3, 6, 3, 8, -1, 4, 5, 6, 1, 8, -1, -1
-1, 9, -1, -1, -1, -1, -1, 6, -1, -1, -1, 5, -1, -1, -1, 3, -1, 3, -1, -1, -1, 3, -1, -1, -1, -1, -1, 7, -1, -1
-1, 9, 6, 2, 9, 4, -1, 5, 5, 4, -1, 3, 1, 4, -1, 7, -1, 7, 7, 2, -1, 5, -1, 6, 2, 2, 1, 4, -1, -1
-1, 7, -1, 2, -1, 3, -1, -1, -1, -1, -1, -1, -1, -1, -1, 5, -1, -1, -1, -1, -1, -1, -1, 7, -1, -1, -1, -1, -1, -1
-1, 8, -1, 2, -1, 7, -1, 2, -1, 3, -1, 6, 4, 9, -1, 5, 2, 4, 5, 2, 7, 9, 2, 2, 6, 1, 7, 8, -1, -1
-1, 4, -1, -1, -1, -1, -1, 6, -1, 7, -1, 4, -1, -1, -1, -1, -1, -1, -1, -1, -1, -1, -1, 1, -1, -1, -1, 3, -1, -1
-1, 4, 5, 3, 3, 3, 7, 4, 3, 3, 8, 9, 2, 9, 9, 6, 3, 3, 4, 6, 8, 1, -1, 1, 8, 3, -1, 4, -1, -1
-1, 8, -1, -1, -1, -1, -1, -1, -1, -1, -1, -1, -1, -1, -1, -1, -1, -1, -1, -1, -1, -1, -1, -1, -1, -1, -1, -1, -1, -1
-1, 4, 6, 4, 9, 2, 5, 4, 3, 6, 2, 5, 2, 3, 7, 7, 3, 4, 9, 6, 7, 8, 3, 4, 5, 1, 5, 6, -1, -1
-1, 3, -1, -1, -1, 6, -1, 7, -1, 4, -1, -1, -1, -1, -1, -1, -1, -1, -1, 9, -1, -1, -1, -1, -1, -1, -1, -1, -1, -1
-1, 6, 2, 2, -1, 6, -1, 2, -1, 7, 4, 4, 7, 1, 5, 4, 3, 7, -1, 8, 3, 2, 4, 8, 5, 5, 4, 1, -1, -1
-1, 7, -1, -1, -1, 9, -1, 3, -1, 4, -1, -1, -1, -1, -1, -1, -1, -1, -1, 8, -1, -1, -1, 7, -1, -1, -1, 3, -1, -1
-1, 4, 5, 4, -1, 6, -1, 1, -1, 9, 6, 1, 2, 2, 6, 9, 5, 2, -1, 6, 7, 2, -1, 4, 3, 3, -1, 1, -1, -1
-1, 2, -1, 2, -1, 7, -1, 7, -1, -1, -1, -1, -1, -1, -1, -1, -1, 9, -1, 7, -1, -1, -1, -1, -1, -1, -1, -1, -1, -1
-1, 7, -1, 8, -1, 8, -1, 7, 7, 2, 2, 9, 9, 8, 6, 7, -1, 5, -1, 9, 2, 3, 2, 3, 6, 7, 1, 9, -1, -1
-1, 5, -1, 9, -1, 4, -1, 9, -1, 3, -1, -1, -1, -1, -1, 5, -1, -1, -1, 8, -1, 3, -1, 1, -1, -1, -1, -1, -1, -1
-1, 3, -1, 2, -1, 2, -1, 6, -1, 8, 8, 1, 2, 6, -1, 7, 9, 8, -1, 3, -1, 3, -1, 4, 5, 9, 8, 3, -1, -1
-1, 4, -1, -1, -1, 7, -1, 5, -1, 5, -1, -1, -1, -1, -1, 3, -1, 2, -1, -1, -1, -1, -1, -1, -1, -1, -1, -1, -1, -1
-1, 8, 3, 4, -1, 1, -1, 7, -1, 5, 1, 6, 6, 1, -1, 5, -1, 8, 5, 5, 3, 1, 9, 2, 9, 2, 4, 9, -1, -1
-1, 9, -1, 1, -1, 7, -1, 6, -1, 8, -1, 3, -1, -1, -1, 6, -1, -1, -1, -1, -1, -1, -1, -1, -1, 6, 1, -1, -1, -1
-1, 4, -1, 9, -1, 6, -1, 6, -1, 5, -1, 1, 5, 1, -1, 5, 6, 4, 6, 6, 8, 2, 9, 6, -1, 1, 3, 4, -1, -1
-1, 3, -1, 7, -1, -1, -1, 2, -1, -1, -1, 7, -1, -1, -1, 8, -1, 2, -1, -1, -1, 6, -1, -1, -1, 7, -1, -1, -1, -1
-1, 1, -1, 9, 8, 4, -1, 4, 7, 2, -1, 3, 8, 8, -1, 4, -1, 2, 5, 8, -1, 3, 5, 4, -1, 6, 3, 6, -1, -1
-1, 8, -1, 1, -1, 1, -1, 5, -1, -1, -1, 7, -1, 4, -1, -1, -1, 4, -1, 2, -1, 8, -1, -1, -1, -1, -1, -1, -1, -1
-1, 3, -1, 5, -1, 6, -1, 4, 3, 4, -1, 6, -1, 4, -1, 6, -1, 8, -1, 7, -1, 3, 4, 6, 8, 7, 3, 4, -1, -1
-1, 1, -1, -1, -1, 2, -1, 6, -1, 9, -1, 2, -1, -1, -1, 2, -1, -1, -1, -1, 2, -1, -1, -1, -1, -1, -1, 5, -1, -1
-1, 7, 3, 9, -1, 9, -1, 7, -1, 5, -1, 5, 3, 6, 1, 7, 7, 4, 4, 1, 6, 4, 1, 2, 7, 5, -1, 8, -1, -1
-1, -1, -1, -1, -1, -1, -1, -1, -1, -1, -1, -1, -1, -1, -1, -1, -1, -1, -1, -1, -1, -1, -1, -1, -1, -1, -1, -1, -1, -1
-1, -1, -1, -1, -1, -1, -1, -1, -1, -1, -1, -1, -1, -1, -1, -1, -1, -1, -1, -1, -1, -1, -1, -1, -1, -1, -1, -1, -1, -1