idastar
20
2,2
18,17
2, -1, 2, 9, 2, 3, -1, 8, 9, -1, 5, -1, 4, -1, -1, -1, 3, -1, 9, 2
9, 6, 5, 5, 7, 7, 6, 2, 5, 5, 7, 3, 9, 3, 9, 8, 1, 7, 6, -1
-1, 5, 2, 8, 2, -1, 4, 4, -1, 6, 2, -1, 5, 9, 2, 2, -1, 1, 3, 7
-1, 8, -1, 5, 4, 3, 3, 4, 3, 7, 2, 7, 1, 7, 5, 1, 7, 4, -1, -1
-1, 6, 4, 7, -1, -1, 7, 8, -1, 9, 5, -1, 1, -1, -1, 7, 6, -1, -1, 6
-1, 9, 7, 2, 6, 4, 6, 5, -1, 9, 5, 6, 3, 5, 7, 1, 9, 9, 5, 9
6, 1, -1, 9, -1, -1, 8, 4, 3, 1, 5, 3, 7, -1, 1, 7, 8, 7, 8, 1
1, 1, -1, 4, 3, 2, 9, 4, 8, 1, 8, 6, 5, 9, 5, 5, 6, 7, -1, 8
-1, 8, 4, 9, 7, 1, 2, 5, 8, 2, 9, -1, 5, -1, -1, 4, 2, -1, 7, -1
5, 2, 4, 1, -1, 3, 6, 5, 2, 7, 6, 6, 4, 1, 2, 7, 1, 6, -1, 9
-1, 7, 2, 9, 5, -1, 1, 7, -1, 3, -1, 1, -1, -1, 3, -1, 9, 1, 7, -1
3, 7, -1, 5, 5, 9, 4, 8, 7, 6, 7, 8, 8, 6, 6, 1, -1, 5, 7, 1
7, 3, 6, 7, 5, 1, -1, -1, -1, 3, 1, 2, 7, 1, 1, 3, -1, 1, -1, 9
-1, 8, -1, 5, 2, 2, -1, 9, 7, 4, 1, 5, 2, 4, 7, 9, 2, 2, 4, -1
8, 8, 2, 2, -1, 7, 2, -1, -1, 9, -1, -1, -1, 1, 2, 8, -1, 7, 6, -1
-1, 3, -1, 1, 4, 6, -1, 2, 5, 2, 7, 5, 3, 3, 8, 4, -1, 2, -1, -1
2, -1, -1, 6, -1, 9, 4, 4, 4, 8, 6, -1, 5, 3, -1, -1, -1, 6, -1, 4
1, 7, 4, 2, 9, 5, 1, 5, -1, 1, 1, 7, 3, 2, 6, 9, 1, 9, 7, 4
-1, -1, 4, 5, -1, 9, -1, -1, -1, 4, 4, -1, -1, 4, -1, -1, -1, 7, 6, 8
-1, -1, 3, 3, -1, -1, -1, 1, -1, -1, -1, 1, -1, -1, 4, 2, -1, -1, 3, 1