UCS
24
1,1
21,21
-1, 9, -1, 1, -1, 9, -1, -1, -1, 4, 5, 5, -1, -1, 9, -1, -1, -1, -1, -1, -1, 7, -1, 9
-1, 1, 9, 4, 3, 4, 2, 5, 3, 5, -1, 6, 4, 4, 1, 4, 1, 3, 6, 2, 4, 3, -1, 7
-1, 1, -1, 5, 5, -1, -1, 1, 6, 1, -1, 1, -1, 4, 7, 8, 2, 9, -1, 6, 2, 8, -1, 8
8, 1, 2, 1, 6, 1, 1, 2, 1, 5, 9, 9, 5, 1, 4, 6, 4, 2, 5, 3, 8, 9, 9, 3
4, 1, -1, 7, -1, 4, -1, 6, 6, 7, -1, 4, 2, -1, 3, 5, 1, 9, 2, -1, 8, 6, -1, 3
9, 8, -1, 1, 7, 4, 5, 6, 9, 5, -1, 6, 5, 6, 9, 3, -1, 6, 2, 8, 5, 4, 8, 8
-1, 2, 2, 1, -1, 8, -1, 9, -1, 5, 5, 8, -1, -1, 2, 5, -1, 2, 9, 3, 5, 9, 7, 2
-1, 3, -1, 1, -1, 8, -1, 5, -1, 4, 7, 6, 8, 3, -1, 5, 4, 2, 1, 5, -1, 3, -1, -1
1, 3, 3, 2, 5, 7, -1, 2, 8, 3, -1, 1, -1, -1, 9, 8, -1, 5, 4, 9, 9, 6, 2, 7
4, 9, 3, 2, 9, 6, 9, 1, 2, 4, -1, 3, 5, 5, 7, 7, 2, 5, 2, 7, -1, 1, -1, -1
1, 7, -1, 1, -1, 1, -1, -1, 5, -1, -1, 2, -1, 8, 5, 6, 7, -1, -1, 2, -1, -1, -1, -1
2, 6, -1, 2, 9, 3, 1, 2, 7, 2, -1, 1, 5, 8, 2, 7, 1, 3, 1, 2, 7, 1, -1, -1
3, 7, -1, 4, -1, 8, 6, 3, 6, 6, 2, 6, -1, 6, -1, 4, -1, 1, 3, 6, -1, -1, -1, -1
-1, 1, -1, 9, 2, 8, 5, 1, 4, 6, 4, 4, 3, 7, 7, 5, 6, 1, -1, 7, 2, 2, 5, -1
-1, 5, -1, 9, 4, -1, 5, 5, 8, -1, 2, -1, 6, 5, 8, 6, -1, -1, -1, 8, 1, -1, -1, 2
-1, 9, 8, 9, 2, 2, 2, 5, 7, 1, 5, 2, 4, 7, -1, 5, 5, 1, -1, 8, 4, 7, 2, 2
8, 7, -1, 5, -1, 2, -1, 6, -1, -1, 6, -1, 1, -1, 5, -1, -1, 1, -1, -1, -1, 1, -1, -1
-1, 6, -1, 3, 6, 8, 4, 8, 3, 1, 7, 1, 2, 1, 3, 1, -1, 2, 5, 4, -1, 5, -1, 6
7, -1, -1, 2, -1, 4, 4, -1, -1, 5, 6, -1, 8, -1, 7, 1, 2, 1, -1, 7, -1, 6, -1, -1
-1, 1, 3, 8, -1, 5, 9, 6, 3, 7, 1, 4, 7, 9, 3, 4, 7, 9, 2, 4, 8, 7, -1, -1
6, 3, -1, 4, -1, 7, -1, 2, -1, -1, 8, -1, 6, -1, 4, -1, 5, -1, -1, 3, 6, 4, 4, -1
8, 8, -1, 6, -1, 5, 9, 8, 1, 5, 2, 2, 6, 1, 9, 1, 9, 3, 7, 1, 2, 1, -1, 7
4, -1, 1, -1, 8, 9, 6, -1, 5, -1, -1, -1, 7, -1, 2, -1, 2, 6, 5, 3, -1, -1, 9, 5
6, -1, 4, 4, -1, 2, -1, 3, -1, -1, 1, -1, -1, 5, -1, 5, 2, 9, -1, 4, 4, -1, -1, -1