UCS
8
1,1
6,6
-1, 7, -1, 4, -1, 9, -1, -1
7, 2, 8, 6, 9, 2, -1, 9
5, 3, 7, 1, -1, 4, -1, -1
7, 2, 6, 4, 8, 5, 5, 4
-1, 1, -1, 5, 5, -1, -1, 8
-1, 4, 2, 2, 2, -1, -1, -1
-1, -1, -1, -1, 9, -1, 1, -1
-1, 9, 2, 7, -1, -1, -1, -1