IDASTAR
20
2,1
18,17
-1, -1, -1, -1, -1, -1, 2, -1, -1, -1, -1, -1, -1, -1, -1, -1, -1, -1, -1, -1
-1, 1, 7, 9, -1, 5, -1, 4, 8, 5, 2, 9, 2, 1, 1, 1, 8, 5, -1, -1
-1, 5, -1, 1, 5, 8, 8, 8, -1, -1, -1, 3, -1, -1, -1, 9, -1, 4, -1, -1
-1, 2, -1, 6, 4, 1, -1, 1, 2, 5, 5, 3, 5, 3, -1, 8, -1, 4, -1, -1
-1, 7, -1, -1, -1, -1, -1, 7, -1, -1, -1, -1, -1, 8, -1, -1, -1, 3, -1, -1
-1, 7, 6, 2, 3, 6, 5, 8, 9, 7, 4, 3, -1, 4, 8, 6, -1, 3, -1, -1
-1, 3, -1, -1, -1, -1, -1, 6, -1, 8, -1, -1, -1, -1, -1, -1, -1, 2, -1, -1
-1, 8, 8, 7, 9, 2, 9, 6, -1, 3, 4, 8, 1, 6, 4, 5, 5, 4, -1, -1
-1, 9, -1, -1, -1, 1, -1, -1, -1, -1, 4, 6, -1, 2, -1, 4, 5, -1, -1, -1
-1, 9, 9, 7, -1, 9, 6, 3, 9, 6, -1, 1, -1, 8, -1, 2, 9, 9, -1, -1
-1, 6, -1, 8, -1, 4, -1, 1, -1, 6, -1, 3, -1, 9, -1, 8, -1, -1, -1, -1
-1, 8, -1, 1, -1, 2, -1, 2, -1, 1, -1, 2, -1, 4, -1, 7, 4, 8, -1, -1
-1, 7, -1, -1, -1, 4, -1, 3, -1, 8, -1, 6, -1, 8, -1, -1, 6, -1, -1, -1
-1, 8, 2, 7, -1, 6, -1, 8, -1, 2, -1, 5, -1, 3, 2, 5, 1, 9, -1, -1
-1, 7, -1, -1, -1, 6, -1, 6, -1, -1, -1, -1, -1, 9, -1, -1, -1, -1, -1, -1
-1, 2, 1, 3, -1, 8, -1, 6, 1, 2, 1, 3, -1, 7, 2, 9, 2, 6, -1, -1
-1, 5, -1, -1, -1, -1, -1, -1, -1, -1, -1, -1, -1, 3, -1, 7, -1, 9, 4, -1
-1, 3, 3, 2, 9, 7, 5, 4, 9, 3, 3, 8, 5, 1, 8, 4, -1, 5, 2, -1
-1, -1, 9, -1, -1, -1, 3, -1, -1, -1, -1, -1, -1, -1, -1, -1, -1, 1, -1, -1
5, -1, -1, -1, -1, -1, -1, -1, -1, 8, -1, -1, -1, -1, -1, -1, -1, -1, -1, -1