Astar
60
7,2
58,7
-1, -1, -1, -1, -1, -1, -1, 8, -1, -1, -1, 7, -1, -1, -1, -1, -1, -1, 6, -1, -1, -1, 4, -1, -1, -1, -1, -1, -1, -1, -1, -1, -1, -1, -1, -1, -1, -1, -1, -1, -1, -1, -1, 9, -1, -1, -1, 6, -1, -1, 4, -1, -1, -1, 3, -1, -1, -1, 7, 5
-1, -1, -1, -1, -1, -1, -1, 1, -1, -1, -1, -1, -1, -1, -1, -1, -1, 6, -1, -1, -1, -1, -1, 8, 9, -1, -1, -1, -1, -1, -1, -1, -1, -1, 4, -1, 6, -1, -1, -1, -1, -1, -1, -1, 2, -1, -1, -1, -1, -1, -1, 9, -1, 6, 6, -1, -1, -1, 8, -1
8, 6, 9, 7, 9, 6, 2, 4, 2, 2, 4, 5, 3, 4, 9, 9, 2, 7, 3, 9, 7, 7, 6, 9, 4, 7, 5, 9, 2, 8, 5, 3, 1, 1, 5, 1, 2, 4, 5, 5, 9, 6, 5, 7, 6, 5, 8, 8, 2, 8, 1, 6, 3, 5, 2, 7, 6, 7, 9, 5
7, -1, -1, -1, -1, -1, -1, 5, -1, -1, -1, -1, -1, -1, -1, -1, -1, -1, -1, -1, -1, -1, -1, -1, -1, -1, -1, -1, -1, -1, -1, -1, -1, -1, 7, -1, -1, -1, -1, -1, -1, -1, -1, -1, -1, -1, 8, -1, -1, -1, -1, 2, -1, -1, -1, -1, -1, -1, 6, -1
-1, -1, 1, -1, -1, -1, -1, 1, 3, -1, -1, -1, -1, -1, -1, -1, -1, -1, -1, -1, -1, -1, -1, -1, -1, -1, 3, -1, -1, -1, -1, -1, -1, -1, -1, -1, -1, -1, 8, -1, 1, -1, -1, -1, -1, -1, -1, -1, -1, -1, -1, 2, -1, -1, -1, -1, 3, 8, 7, -1
-1, -1, -1, -1, -1, 8, -1, 8, -1, -1, -1, -1, -1, -1, -1, -1, -1, -1, -1, 9, -1, -1, 7, 7, -1, -1, -1, -1, -1, -1, -1, -1, -1, 6, -1, -1, -1, -1, -1, -1, -1, 1, -1, -1, 8, -1, -1, -1, -1, -1, -1, -1, -1, -1, 5, -1, -1, -1, 8, -1
-1, -1, 1, -1, -1, -1, -1, 6, -1, -1, 3, -1, -1, -1, -1, 3, -1, -1, -1, -1, -1, -1, -1, -1, -1, -1, -1, -1, -1, -1, -1, -1, -1, -1, -1, 3, -1, -1, -1, 4, -1, -1, -1, -1, -1, -1, -1, -1, -1, -1, -1, -1, -1, -1, 5, -1, -1, -1, 2, -1
2, 1, 3, 6, 4, 2, 5, 7, 2, 6, 7, 5, 8, 4, 4, 7, 4, 2, 8, 6, 5, 4, 5, 9, 1, 1, 4, 4, 5, 4, 4, 1, 6, 8, 4, 3, 7, 5, 1, 5, 4, 4, 2, 9, 8, 8, 8, 5, 4, 8, 7, 7, 5, 7, 7, 4, 4, 5, 8, 7
-1, -1, -1, -1, -1, -1, -1, 2, -1, -1, -1, -1, -1, -1, -1, 9, -1, -1, -1, -1, -1, -1, -1, -1, 6, -1, -1, -1, -1, -1, -1, -1, -1, -1, -1, -1, -1, -1, -1, 2, -1, -1, -1, -1, -1, -1, -1, -1, -1, -1, -1, -1, -1, 2, -1, 9, 4, -1, 8, -1
-1, -1, -1, -1, -1, -1, -1, 5, -1, -1, -1, -1, -1, -1, -1, -1, -1, -1, 4, -1, -1, -1, -1, 4, -1, -1, -1, -1, 3, -1, -1, -1, 3, -1, -1, -1, -1, -1, -1, -1, -1, -1, 4, -1, -1, 6, -1, -1, -1, -1, -1, -1, -1, -1, -1, -1, -1, -1, 3, 3
-1, -1, -1, -1, -1, -1, -1, 1, -1, -1, 8, -1, -1, -1, -1, -1, -1, -1, -1, -1, -1, -1, -1, -1, -1, -1, -1, -1, -1, -1, 1, -1, -1, -1, -1, -1, -1, -1, -1, -1, -1, -1, -1, -1, -1, -1, -1, -1, -1, 4, 7, -1, -1, -1, -1, -1, -1, -1, 8, -1
-1, 7, -1, -1, -1, -1, -1, 8, -1, -1, 4, -1, 2, 4, -1, -1, -1, -1, -1, -1, -1, -1, -1, -1, -1, -1, -1, -1, -1, -1, -1, -1, 6, -1, 5, -1, -1, -1, -1, -1, -1, -1, -1, -1, -1, -1, -1, -1, -1, -1, -1, -1, -1, -1, -1, -1, -1, 9, 9, -1
-1, -1, -1, -1, -1, -1, -1, 8, 2, -1, -1, -1, -1, -1, -1, -1, -1, -1, -1, -1, -1, -1, -1, -1, 4, -1, -1, -1, -1, -1, -1, -1, -1, -1, -1, -1, -1, -1, 7, -1, -1, -1, -1, -1, -1, -1, -1, -1, -1, -1, 8, -1, -1, -1, -1, -1, -1, -1, 1, -1
-1, 6, -1, -1, -1, -1, -1, 8, -1, -1, -1, -1, -1, -1, -1, -1, -1, -1, -1, -1, -1, -1, -1, -1, -1, -1, -1, -1, -1, -1, -1, -1, -1, -1, -1, -1, 3, -1, -1, -1, -1, 1, -1, -1, 1, -1, -1, -1, -1, -1, -1, -1, -1, -1, -1, -1, -1, -1, 6, -1
2, -1, -1, -1, -1, 7, -1, 2, -1, 3, -1, -1, 7, -1, -1, -1, -1, -1, -1, -1, -1, -1, -1, -1, 8, -1, -1, -1, -1, -1, -1, -1, -1, -1, -1, -1, -1, -1, -1, -1, 4, -1, 5, -1, -1, -1, -1, -1, -1, -1, -1, -1, -1, -1, -1, -1, -1, 3, 8, -1
-1, -1, -1, -1, -1, -1, -1, 1, 3, -1, -1, -1, -1, -1, -1, -1, -1, -1, -1, 6, -1, -1, -1, -1, -1, -1, -1, -1, -1, -1, -1, -1, -1, -1, -1, -1, -1, -1, 4, -1, -1, -1, -1, -1, -1, -1, -1, -1, -1, 6, 6, -1, -1, -1, -1, -1, -1, 3, 2, -1
-1, -1, -1, -1, -1, -1, -1, 5, -1, -1, -1, -1, -1, -1, -1, -1, -1, -1, -1, -1, -1, -1, -1, -1, -1, -1, -1, -1, -1, -1, 7, -1, -1, -1, -1, -1, -1, -1, -1, 9, -1, 4, -1, -1, -1, -1, -1, -1, 5, -1, 6, -1, -1, -1, -1, -1, -1, -1, 1, -1
-1, -1, -1, -1, -1, -1, -1, 6, -1, -1, -1, -1, -1, -1, -1, -1, -1, -1, -1, -1, -1, 5, -1, -1, -1, -1, -1, -1, 2, -1, -1, -1, -1, -1, -1, -1, -1, -1, -1, 9, -1, -1, -1, -1, -1, -1, -1, -1, 8, 6, -1, -1, 8, 2, -1, -1, -1, -1, 4, -1
-1, -1, -1, -1, -1, -1, 6, 8, -1, -1, -1, -1, -1, -1, -1, -1, -1, 4, -1, -1, 1, -1, -1, -1, -1, -1, -1, -1, -1, 2, -1, -1, -1, -1, -1, -1, -1, -1, -1, -1, -1, -1, -1, -1, -1, -1, -1, 5, -1, -1, -1, -1, -1, -1, -1, -1, -1, -1, 5, -1
-1, -1, 8, -1, -1, -1, -1, 5, -1, -1, -1, -1, -1, -1, 7, 3, 5, -1, 1, -1, -1, -1, -1, -1, -1, -1, -1, -1, -1, -1, -1, -1, -1, -1, -1, 9, -1, 2, -1, -1, -1, -1, -1, -1, -1, -1, -1, -1, -1, -1, -1, -1, -1, -1, 1, 1, -1, -1, 9, 8
-1, -1, 6, -1, 4, -1, -1, 8, -1, -1, -1, -1, -1, -1, -1, -1, 3, -1, -1, -1, -1, -1, -1, -1, -1, -1, -1, -1, -1, -1, -1, -1, -1, 2, -1, -1, -1, -1, -1, -1, -1, -1, -1, -1, 4, -1, -1, -1, -1, -1, -1, 7, -1, -1, -1, -1, -1, -1, 4, -1
-1, -1, -1, -1, -1, -1, 7, 2, -1, 6, -1, -1, -1, 3, -1, -1, -1, -1, -1, -1, -1, -1, 1, -1, -1, -1, -1, -1, -1, 6, -1, -1, -1, -1, -1, -1, -1, 2, -1, -1, -1, 9, -1, -1, -1, -1, -1, -1, -1, -1, -1, -1, 1, -1, -1, -1, -1, -1, 6, -1
-1, -1, -1, -1, -1, -1, -1, 4, 3, 1, -1, -1, -1, -1, -1, 8, -1, -1, 7, -1, -1, -1, -1, -1, -1, -1, -1, -1, 1, -1, -1, 6, -1, -1, -1, -1, 8, -1, 9, -1, -1, -1, -1, -1, -1, -1, 1, -1, -1, -1, -1, 3, -1, -1, -1, -1, 7, -1, 6, 2
-1, 1, -1, -1, -1, -1, -1, 3, -1, -1, -1, -1, -1, -1, -1, -1, -1, -1, -1, -1, -1, -1, 2, 8, 4, -1, -1, -1, -1, -1, -1, -1, -1, -1, -1, -1, -1, -1, -1, -1, 7, -1, 7, -1, -1, -1, -1, -1, -1, 2, -1, -1, -1, -1, -1, -1, -1, -1, 1, -1
1, -1, -1, -1, -1, -1, 2, 8, -1, -1, -1, 8, -1, -1, -1, -1, 6, -1, -1, -1, -1, -1, -1, 6, -1, -1, -1, 7, -1, -1, -1, -1, 7, -1, -1, -1, -1, -1, -1, -1, -1, -1, -1, -1, -1, -1, -1, -1, -1, -1, -1, -1, -1, -1, -1, -1, -1, -1, 4, -1
-1, -1, 2, -1, -1, -1, -1, 8, -1, -1, -1, -1, -1, -1, -1, -1, 9, -1, 1, -1, -1, -1, -1, 7, -1, -1, 7, -1, -1, -1, -1, 8, -1, -1, 5, -1, -1, -1, -1, -1, -1, -1, 1, 7, -1, -1, -1, -1, -1, -1, 5, -1, -1, -1, -1, 5, -1, -1, 8, -1
-1, -1, -1, 8, -1, 4, -1, 8, -1, -1, -1, -1, -1, -1, -1, -1, -1, -1, -1, -1, 9, -1, -1, -1, -1, -1, -1, -1, -1, -1, -1, -1, -1, -1, -1, -1, -1, -1, -1, -1, -1, -1, -1, -1, -1, -1, -1, 2, -1, -1, -1, -1, -1, -1, -1, 5, -1, 4, 5, -1
-1, -1, -1, -1, -1, -1, -1, 4, -1, -1, -1, -1, -1, -1, -1, 4, -1, -1, -1, -1, -1, -1, -1, -1, -1, -1, -1, -1, -1, 9, -1, -1, 5, -1, -1, -1, -1, -1, -1, -1, -1, -1, -1, -1, -1, -1, -1, -1, -1, -1, -1, -1, -1, -1, -1, 5, -1, -1, 7, -1
7, 6, 4, -1, -1, -1, -1, 3, -1, -1, -1, -1, -1, -1, -1, -1, -1, -1, -1, -1, -1, -1, -1, -1, -1, -1, -1, -1, -1, 8, -1, -1, -1, -1, -1, -1, -1, -1, -1, -1, -1, -1, -1, -1, -1, -1, -1, 1, -1, -1, -1, -1, -1, 8, -1, -1, -1, -1, 1, -1
-1, -1, -1, -1, -1, -1, 2, 9, -1, -1, -1, -1, -1, -1, -1, -1, -1, -1, -1, -1, -1, -1, -1, -1, -1, -1, -1, -1, -1, -1, -1, -1, -1, -1, -1, -1, -1, 6, -1, -1, -1, 2, 7, -1, -1, -1, -1, -1, -1, -1, -1, -1, -1, -1, -1, -1, -1, -1, 6, -1
-1, -1, -1, -1, -1, -1, -1, 5, 2, 1, -1, -1, -1, -1, -1, -1, -1, 5, -1, -1, -1, -1, 4, -1, 9, -1, -1, -1, -1, -1, -1, -1, -1, -1, -1, -1, -1, -1, -1, -1, -1, -1, -1, -1, -1, -1, -1, -1, -1, -1, -1, -1, -1, -1, -1, -1, -1, -1, 5, -1
-1, -1, -1, -1, -1, 8, 5, 8, -1, -1, -1, -1, -1, -1, -1, -1, -1, -1, 7, -1, -1, -1, -1, -1, -1, -1, -1, -1, -1, -1, -1, -1, -1, -1, -1, -1, -1, -1, -1, -1, -1, -1, -1, -1, -1, -1, -1, -1, -1, -1, -1, -1, 6, -1, -1, -1, -1, -1, 9, -1
-1, -1, -1, -1, -1, 7, -1, 9, -1, -1, -1, -1, -1, -1, -1, -1, -1, -1, -1, -1, 5, -1, -1, -1, -1, -1, 7, -1, -1, -1, -1, -1, -1, -1, -1, -1, -1, -1, -1, -1, -1, -1, -1, -1, -1, -1, -1, -1, -1, -1, -1, -1, -1, -1, -1, -1, -1, -1, 2, -1
-1, -1, 6, -1, -1, -1, -1, 3, -1, -1, -1, -1, 8, -1, -1, -1, -1, -1, -1, -1, -1, -1, -1, -1, -1, -1, -1, -1, 8, -1, -1, -1, -1, -1, -1, -1, -1, -1, -1, -1, -1, -1, -1, -1, -1, -1, -1, -1, 1, -1, -1, -1, -1, 4, -1, -1, -1, -1, 3, -1
-1, -1, -1, -1, -1, -1, -1, 3, -1, -1, -1, -1, -1, -1, -1, -1, -1, -1, -1, -1, -1, -1, -1, -1, -1, -1, 3, -1, -1, -1, -1, -1, -1, 3, 9, 7, -1, -1, -1, -1, 9, -1, -1, -1, -1, -1, 3, -1, -1, -1, -1, -1, -1, -1, -1, -1, -1, -1, 8, 3
-1, -1, -1, -1, -1, -1, -1, 8, -1, -1, -1, -1, -1, -1, -1, -1, -1, -1, -1, -1, -1, -1, 3, -1, -1, -1, -1, -1, -1, 5, -1, -1, -1, -1, -1, -1, -1, -1, -1, -1, 8, 8, -1, -1, -1, -1, 3, -1, -1, -1, -1, -1, -1, -1, -1, -1, -1, -1, 7, -1
-1, -1, -1, -1, -1, -1, -1, 2, -1, -1, -1, 4, 9, -1, 4, -1, -1, -1, -1, 6, -1, -1, -1, -1, -1, -1, -1, -1, -1, 8, -1, -1, -1, -1, -1, -1, -1, -1, -1, -1, -1, -1, -1, -1, 1, 3, -1, -1, -1, -1, -1, -1, -1, -1, -1, -1, -1, -1, 4, -1
-1, -1, 7, -1, 5, -1, -1, 8, -1, -1, -1, -1, -1, -1, -1, -1, -1, -1, -1, 1, -1, -1, -1, 9, -1, -1, -1, -1, -1, -1, -1, -1, -1, -1, -1, -1, -1, -1, -1, -1, -1, -1, -1, -1, -1, -1, -1, -1, -1, -1, -1, 1, -1, 3, -1, -1, -1, -1, 5, -1
-1, -1, -1, -1, -1, -1, -1, 1, -1, -1, -1, -1, -1, -1, -1, -1, -1, -1, -1, -1, -1, 6, -1, -1, -1, -1, -1, -1, -1, -1, -1, 8, 3, -1, -1, -1, -1, -1, -1, -1, -1, -1, -1, -1, -1, -1, -1, -1, -1, -1, -1, -1, 5, -1, 3, -1, -1, -1, 7, -1
-1, 1, -1, -1, -1, -1, -1, 8, -1, -1, -1, -1, -1, -1, -1, -1, -1, -1, -1, -1, -1, -1, -1, -1, -1, -1, -1, -1, -1, -1, -1, -1, -1, -1, -1, 6, -1, -1, -1, -1, 8, -1, -1, -1, -1, -1, -1, -1, -1, -1, -1, -1, -1, -1, 3, -1, -1, -1, 8, -1
-1, -1, 5, -1, -1, -1, -1, 6, -1, -1, -1, -1, -1, -1, 7, -1, -1, -1, -1, -1, -1, -1, -1, -1, -1, -1, -1, -1, -1, -1, -1, -1, -1, -1, -1, -1, -1, -1, -1, -1, -1, -1, -1, 9, -1, -1, -1, -1, -1, -1, -1, -1, -1, -1, -1, -1, -1, -1, 8, -1
-1, 1, 1, -1, -1, -1, 7, 9, -1, -1, -1, -1, -1, -1, -1, -1, -1, -1, -1, 4, -1, -1, -1, -1, -1, -1, -1, -1, -1, -1, -1, -1, -1, -1, -1, -1, -1, -1, -1, -1, -1, -1, -1, -1, -1, -1, -1, -1, 2, -1, -1, -1, -1, -1, -1, -1, -1, -1, 9, 4
-1, -1, -1, -1, -1, -1, -1, 1, 3, -1, -1, -1, 1, -1, -1, -1, 5, -1, -1, -1, -1, -1, -1, -1, -1, -1, -1, -1, -1, -1, -1, -1, -1, -1, -1, 6, -1, -1, -1, -1, -1, -1, 7, -1, -1, -1, -1, -1, 2, -1, -1, -1, 7, -1, -1, -1, -1, -1, 4, 4
-1, -1, -1, -1, -1, 8, -1, 3, 9, 1, -1, 3, -1, -1, 7, -1, -1, -1, 5, -1, -1, -1, -1, -1, 5, -1, -1, -1, -1, -1, -1, -1, -1, 3, -1, 4, -1, -1, -1, -1, -1, -1, -1, -1, -1, -1, -1, -1, -1, -1, -1, -1, -1, -1, -1, -1, -1, -1, 7, -1
-1, -1, -1, -1, -1, -1, -1, 8, -1, -1, -1, -1, -1, -1, -1, -1, -1, -1, 9, -1, -1, -1, -1, -1, 5, -1, -1, -1, -1, -1, -1, -1, -1, -1, -1, 9, -1, 2, -1, -1, -1, -1, -1, 1, -1, -1, -1, 2, -1, -1, -1, -1, -1, 1, -1, 1, -1, -1, 6, -1
-1, -1, -1, -1, -1, -1, -1, 9, -1, -1, -1, -1, -1, -1, -1, -1, 8, -1, -1, -1, -1, -1, -1, -1, -1, -1, -1, 9, -1, -1, -1, -1, 3, -1, 8, -1, -1, -1, -1, -1, -1, -1, 4, -1, -1, -1, -1, -1, -1, -1, -1, -1, -1, -1, -1, -1, -1, -1, 8, -1
-1, -1, 9, -1, 6, -1, -1, 8, -1, -1, -1, -1, -1, -1, -1, -1, -1, -1, -1, -1, -1, -1, -1, -1, 4, -1, -1, -1, -1, -1, -1, -1, -1, -1, -1, -1, -1, 3, -1, 9, -1, -1, -1, -1, 6, -1, -1, -1, -1, -1, -1, -1, -1, -1, -1, 8, -1, -1, 2, -1
-1, -1, -1, -1, -1, -1, -1, 4, -1, -1, -1, -1, -1, -1, -1, 3, -1, -1, -1, -1, -1, -1, 8, 1, -1, -1, -1, -1, 2, 2, -1, -1, 3, -1, -1, -1, -1, -1, -1, -1, -1, -1, 8, -1, -1, 6, -1, -1, 2, -1, 5, -1, 9, 1, -1, -1, -1, 7, 5, -1
8, -1, -1, -1, -1, 5, -1, 9, -1, -1, -1, -1, -1, 4, 9, -1, -1, -1, -1, -1, -1, -1, -1, -1, -1, -1, -1, -1, -1, -1, -1, -1, -1, -1, -1, -1, -1, -1, -1, -1, -1, -1, -1, -1, -1, -1, -1, -1, -1, -1, -1, -1, 4, -1, -1, -1, 8, -1, 3, -1
-1, -1, -1, -1, -1, -1, -1, 1, -1, -1, -1, -1, -1, -1, -1, -1, -1, -1, -1, -1, -1, -1, -1, -1, -1, -1, -1, -1, -1, -1, -1, -1, -1, -1, 6, -1, -1, -1, 3, -1, -1, -1, -1, -1, -1, -1, -1, -1, -1, -1, -1, -1, -1, -1, -1, 8, -1, -1, 6, -1
-1, -1, -1, -1, 2, -1, -1, 8, -1, -1, -1, -1, -1, -1, -1, -1, -1, -1, -1, -1, -1, -1, -1, -1, -1, -1, -1, -1, -1, -1, -1, -1, 3, -1, -1, -1, -1, -1, -1, 8, -1, -1, -1, -1, -1, -1, -1, -1, -1, -1, -1, -1, 5, -1, -1, -1, -1, -1, 7, -1
-1, -1, -1, -1, -1, -1, -1, 9, -1, -1, -1, -1, -1, -1, 3, -1, 6, -1, 1, -1, -1, -1, -1, -1, -1, -1, -1, -1, -1, -1, -1, -1, -1, -1, -1, -1, -1, -1, -1, -1, -1, -1, -1, -1, -1, -1, -1, -1, 9, -1, -1, -1, -1, -1, -1, -1, 7, -1, 6, -1
-1, -1, -1, -1, -1, -1, -1, 3, -1, -1, -1, -1, 5, -1, -1, 6, -1, -1, -1, -1, -1, -1, 1, -1, -1, -1, -1, 3, -1, -1, -1, 6, -1, -1, -1, -1, -1, -1, -1, -1, -1, -1, -1, 6, -1, -1, -1, -1, -1, -1, -1, -1, -1, -1, -1, -1, -1, -1, 6, -1
-1, 8, -1, -1, -1, -1, -1, 9, -1, -1, -1, -1, -1, -1, -1, -1, -1, 4, -1, -1, 2, -1, -1, -1, -1, -1, -1, -1, -1, -1, 3, -1, -1, 5, -1, -1, -1, -1, -1, -1, -1, -1, -1, 4, -1, -1, -1, -1, -1, -1, 2, -1, 7, 8, -1, -1, -1, -1, 2, 7
-1, -1, -1, -1, -1, -1, -1, 2, -1, 7, -1, -1, -1, -1, -1, -1, -1, -1, -1, -1, -1, -1, -1, -1, -1, -1, -1, -1, -1, -1, -1, -1, -1, -1, -1, -1, -1, -1, -1, -1, -1, -1, -1, -1, -1, -1, 6, -1, -1, -1, -1, -1, -1, -1, -1, -1, 7, -1, 6, -1
-1, -1, -1, -1, -1, -1, -1, 2, -1, -1, 8, -1, -1, -1, -1, -1, -1, -1, -1, -1, -1, -1, -1, -1, -1, -1, -1, -1, -1, -1, -1, -1, -1, -1, -1, 1, -1, -1, -1, 1, -1, 5, -1, -1, -1, -1, -1, -1, -1, -1, -1, -1, -1, -1, -1, -1, -1, -1, 7, -1
-1, -1, -1, -1, -1, -1, -1, 1, -1, -1, -1, -1, -1, -1, 7, -1, 7, 6, -1, -1, -1, -1, -1, -1, -1, -1, -1, -1, -1, -1, -1, -1, -1, 4, -1, -1, -1, -1, -1, 7, -1, -1, -1, -1, 3, -1, -1, -1, -1, -1, -1, -1, -1, -1, -1, -1, -1, -1, 3, -1
-1, 7, -1, -1, -1, -1, -1, 1, -1, -1, -1, -1, -1, 1, -1, -1, -1, -1, -1, -1, -1, -1, 7, -1, -1, -1, -1, -1, -1, -1, -1, -1, -1, -1, -1, -1, -1, -1, -1, -1, -1, -1, -1, -1, -1, -1, -1, -1, 5, -1, -1, -1, 9, -1, 7, -1, -1, -1, 7, -1
-1, 7, -1, -1, -1, -1, -1, 1, -1, 4, -1, -1, -1, -1, -1, -1, -1, -1, -1, -1, -1, -1, -1, -1, -1, -1, -1, -1, 3, -1, -1, -1, -1, -1, -1, -1, -1, -1, 2, -1, -1, -1, -1, -1, -1, -1, -1, -1, -1, -1, -1, -1, -1, -1, -1, -1, -1, -1, 1, -1
-1, -1, -1, -1, -1, -1, -1, 2, -1, -1, -1, -1, -1, -1, -1, -1, -1, -1, -1, -1, -1, -1, -1, -1, -1, -1, -1, -1, -1, -1, -1, 7, -1, -1, -1, -1, -1, -1, -1, -1, -1, -1, -1, -1, -1, -1, -1, 8, -1, -1, -1, -1, -1, -1, -1, -1, -1, -1, 9, -1