astar
35
1,1
32,32
-1, 4, -1, -1, -1, 8, -1, -1, -1, 1, -1, -1, 7, -1, -1, -1, -1, -1, -1, -1, -1, -1, -1, 3, -1, -1, -1, -1, -1, -1, -1, -1, -1, -1, 8
8, 5, 6, 9, 4, 4, 9, 7, 7, 4, 5, 5, 8, 2, -1, 4, 7, 1, 8, 9, -1, 9, -1, 9, 4, 5, -1, 5, 9, 6, -1, 8, 8, 5, -1
-1, 3, -1, 6, 1, -1, -1, -1, -1, -1, -1, 2, -1, -1, -1, 6, -1, -1, -1, -1, -1, 8, -1, 9, -1, 2, -1, 8, -1, 3, -1, 3, -1, -1, -1
-1, 5, -1, 5, 8, 2, 3, 9, -1, 4, -1, 7, 3, 2, -1, 9, 2, 6, 3, 8, 1, 4, 2, 2, 9, 8, 4, 9, 3, 2, 1, 9, 6, 7, -1
-1, 2, -1, -1, -1, 4, -1, 9, -1, 6, -1, -1, -1, -1, -1, 7, 3, -1, -1, -1, -1, -1, 9, -1, -1, 6, -1, 7, -1, 9, -1, -1, -1, -1, -1
-1, 4, 8, 3, 3, 9, 9, 5, 2, 6, 2, 2, 2, 6, 1, 3, 7, 8, 4, 5, 4, 6, 6, 2, -1, 8, -1, 5, -1, 1, 1, 7, 8, 3, -1
-1, 9, -1, -1, -1, 4, -1, 5, -1, -1, -1, -1, -1, -1, -1, -1, -1, 6, -1, 8, 1, -1, -1, -1, -1, 8, -1, 6, -1, -1, -1, 8, -1, -1, -1
-1, 3, 5, 1, -1, 8, -1, 3, 4, 4, 5, 6, -1, 3, 1, 9, 3, 1, 5, 6, 5, 7, 9, 8, 9, 2, -1, 3, 7, 4, 8, 5, -1, 1, -1
-1, 5, -1, 1, -1, -1, -1, -1, -1, -1, -1, -1, -1, 8, 7, -1, -1, -1, -1, -1, -1, -1, -1, 7, -1, -1, -1, 8, -1, -1, -1, 7, -1, 4, -1
-1, 5, -1, 9, 3, 3, 5, 2, 3, 7, 4, 8, 1, 7, 7, 6, 9, 6, 3, 2, 6, 1, -1, 8, 7, 9, 5, 8, 1, 1, -1, 1, -1, 6, -1
-1, 3, -1, 6, -1, -1, -1, 9, -1, 3, -1, -1, -1, -1, -1, 5, -1, -1, -1, -1, -1, -1, -1, 5, -1, 3, -1, -1, -1, 1, -1, -1, -1, 7, 8
-1, 2, 9, 7, 7, 8, 5, 7, 3, 3, 4, 3, 3, 2, -1, 7, 6, 8, 4, 5, 7, 1, 9, 1, 8, 3, 8, 7, -1, 7, 8, 3, 4, 2, -1
-1, -1, 7, 4, -1, 4, -1, -1, -1, 9, -1, 9, -1, 3, -1, -1, -1, 2, -1, -1, -1, 2, 1, -1, -1, 1, -1, -1, -1, 5, -1, -1, -1, 6, 8
-1, 2, 1, 8, -1, 6, 5, 2, -1, 4, -1, 4, 9, 4, 7, 7, 1, 9, 5, 9, -1, 7, 7, 8, -1, 5, 8, 8, 8, 7, 4, 4, -1, 6, -1
-1, 1, -1, 2, -1, -1, -1, -1, -1, -1, -1, 1, 8, 6, -1, 2, -1, 4, -1, -1, -1, -1, -1, -1, 4, -1, -1, -1, -1, -1, 2, -1, -1, 1, -1
-1, 6, -1, 3, 3, 4, 9, 7, 4, 2, -1, 3, 8, 3, -1, 8, -1, 8, 8, 9, 5, 6, 3, 1, 6, 6, 4, 2, 8, 6, 7, 7, -1, 7, 6
-1, -1, -1, 3, 5, 5, -1, -1, -1, -1, 8, 6, -1, -1, -1, 4, -1, 8, -1, -1, -1, -1, -1, -1, -1, 9, -1, 1, -1, 9, -1, 1, -1, 9, -1
-1, 9, 3, 8, -1, 4, 2, 6, 1, 2, -1, 8, 1, 4, -1, 8, -1, 7, 1, 7, 2, 5, 9, 2, -1, 4, -1, 8, -1, 2, -1, 7, -1, 5, -1
-1, -1, -1, 3, -1, -1, -1, -1, -1, 1, -1, -1, -1, -1, -1, 4, -1, -1, -1, -1, -1, -1, -1, 4, -1, -1, -1, -1, -1, 2, -1, -1, -1, -1, -1
-1, 7, 5, 9, 6, 6, 6, 2, -1, 6, 1, 2, 5, 3, 4, 3, 7, 3, 5, 1, 8, 3, -1, 6, 3, 6, 6, 4, -1, 8, 3, 9, 7, 1, -1
2, -1, -1, 8, 6, 6, -1, -1, -1, -1, -1, 3, -1, -1, -1, 2, -1, -1, -1, -1, -1, -1, -1, -1, -1, 9, -1, 5, -1, 8, -1, -1, -1, -1, -1
-1, 6, 8, 6, -1, 3, 5, 4, 1, 7, 7, 9, 2, 9, -1, 2, 1, 9, 5, 4, 8, 1, 9, 3, -1, 7, -1, 1, -1, 4, 9, 5, 2, 7, -1
-1, -1, -1, 8, -1, 2, -1, -1, 8, 9, -1, 8, -1, 9, -1, 6, -1, 8, -1, 3, 4, 4, -1, 3, 1, 1, -1, -1, 8, -1, -1, -1, -1, 9, -1
-1, 3, 2, 8, -1, 7, 3, 7, 2, 4, 3, 1, 2, 3, -1, 8, 5, 3, -1, 9, -1, 4, -1, 7, -1, 5, 4, 7, 9, 9, 6, 1, 6, 1, 5
-1, 7, 6, 4, -1, 9, -1, 6, -1, 4, -1, 6, -1, 5, -1, 8, -1, -1, -1, 6, -1, 3, -1, -1, -1, -1, -1, 3, 9, 7, -1, -1, -1, -1, -1
-1, 6, -1, 2, 4, 2, -1, 4, 6, 3, -1, 7, -1, 1, -1, 9, 1, 9, -1, 6, 6, 4, 1, 9, 3, 6, -1, 2, 2, 3, 8, 3, 5, 9, -1
8, 2, -1, 7, -1, 3, -1, 6, -1, 7, -1, 3, -1, 5, -1, 1, -1, 5, -1, -1, -1, 2, -1, -1, -1, 8, -1, 2, -1, 1, -1, 6, -1, 1, -1
-1, 7, -1, 8, -1, 4, 7, 5, -1, 4, 8, 9, 2, 2, 9, 7, -1, 9, 5, 3, -1, 7, 1, 3, -1, 5, -1, 2, -1, 9, 8, 1, -1, 4, -1
-1, -1, -1, 4, -1, 3, -1, 7, -1, -1, -1, 1, -1, 3, -1, 5, -1, 1, -1, -1, -1, 7, -1, 3, -1, -1, -1, 9, -1, 3, -1, 5, -1, 3, -1
5, 3, 1, 8, -1, 8, -1, 6, 4, 4, -1, 8, -1, 3, -1, 7, -1, 2, 6, 1, -1, 3, -1, 4, 2, 7, -1, 6, -1, 7, -1, 1, -1, 3, -1
-1, 2, -1, 8, -1, 1, -1, 4, -1, 9, -1, 3, 7, 3, -1, -1, -1, -1, -1, 8, -1, -1, -1, -1, -1, -1, -1, -1, -1, 2, -1, 4, -1, 7, 4
-1, 5, -1, 9, -1, 1, -1, 9, -1, 9, -1, 7, -1, 5, 7, 5, 8, 8, -1, 2, -1, 6, 3, 8, 5, 6, 9, 8, 4, 1, -1, 9, -1, 6, -1
-1, 4, -1, 3, -1, 2, -1, 6, -1, -1, -1, 3, -1, 5, 6, -1, -1, -1, -1, 6, -1, 5, -1, -1, -1, -1, -1, -1, -1, -1, -1, 2, 7, 7, -1
8, 9, -1, 5, -1, 2, -1, 4, 2, 7, -1, 4, -1, 9, 9, 2, 2, 8, 2, 1, 8, 8, 3, 1, 3, 2, 2, 1, -1, 2, 6, 3, -1, 5, -1
-1, -1, 5, -1, -1, -1, -1, -1, -1, -1, -1, -1, -1, -1, -1, -1, -1, -1, -1, -1, 3, -1, -1, -1, 1, -1, 1, -1, -1, -1, -1, -1, 2, -1, -1