ASTAR
8
1,2
5,6
-1, -1, 2, -1, 2, 6, -1, 8
-1, 5, 2, 1, 9, 1, -1, 5
-1, 3, 2, 7, 3, 6, -1, 7
6, 8, -1, 5, 5, 9, -1, -1
-1, 8, -1, -1, 4, 6, 2, -1
6, 7, 6, 1, 3, 6, 6, -1
5, 6, 5, -1, 5, 3, -1, -1
1, -1, 8, -1, -1, -1, -1, -1
