ASTAR
40
3,3
35,35
-1, -1, -1, -1, -1, -1, -1, -1, -1, -1, -1, -1, -1, -1, -1, -1, -1, -1, -1, -1, -1, -1, -1, -1, -1, -1, -1, -1, -1, -1, -1, -1, -1, -1, -1, -1, -1, -1, -1, -1
-1, 4, 8, 1, 1, 3, 6, 4, 1, 1, 6, 5, 8, 9, 8, 9, -1, 7, -1, 7, 8, 8, 7, 7, 3, 6, 8, 1, 5, 7, 8, 9, 7, 5, 4, 3, 1, 8, -1, -1
-1, 5, -1, -1, -1, -1, -1, -1, -1, -1, -1, -1, -1, -1, -1, -1, -1, 7, -1, 2, -1, -1, -1, -1, -1, -1, -1, -1, -1, -1, -1, -1, -1, 7, -1, 6, -1, -1, -1, -1
-1, 8, 9, 1, 8, 4, 8, 5, 1, 5, 3, 5, -1, 5, 6, 6, 5, 2, -1, 4, 6, 7, -1, 4, 7, 7, 8, 1, 9, 6, 9, 5, -1, 8, -1, 4, 5, 4, -1, -1
-1, 4, -1, 2, -1, -1, -1, -1, -1, -1, -1, 7, -1, 7, -1, -1, -1, -1, -1, 6, -1, -1, -1, 5, -1, -1, -1, 4, -1, 4, -1, -1, -1, -1, -1, -1, -1, -1, -1, -1
-1, 5, -1, 3, 1, 3, 6, 8, 1, 2, -1, 8, 4, 6, 5, 5, -1, 7, 8, 6, 7, 1, 8, 7, 8, 9, -1, 4, -1, 3, 3, 1, -1, 9, 9, 5, 9, 6, -1, -1
-1, 5, -1, -1, -1, 8, -1, 6, -1, -1, -1, -1, -1, -1, -1, -1, -1, 5, -1, -1, -1, 4, -1, 6, -1, -1, -1, -1, -1, -1, -1, 8, -1, 9, -1, -1, -1, -1, -1, -1
-1, 5, 8, 2, -1, 6, -1, 4, 9, 5, 5, 1, 2, 5, 8, 1, 6, 6, 8, 1, -1, 3, -1, 1, 1, 5, 7, 1, 1, 2, -1, 4, 3, 4, 4, 2, 5, 5, -1, -1
-1, 6, -1, 3, -1, -1, -1, -1, -1, -1, -1, -1, -1, -1, -1, -1, -1, -1, -1, -1, -1, 1, -1, -1, -1, -1, -1, -1, -1, -1, -1, -1, -1, -1, -1, 4, -1, -1, -1, -1
-1, 3, -1, 8, 6, 8, 1, 4, 2, 9, 3, 9, 2, 3, 2, 7, 1, 4, 9, 5, -1, 3, 1, 7, 5, 3, 2, 8, 8, 1, 5, 2, 9, 1, -1, 8, 1, 5, -1, -1
-1, 4, -1, 7, -1, 8, -1, 8, -1, 5, -1, 2, -1, -1, -1, -1, -1, -1, -1, -1, -1, -1, -1, 5, -1, -1, -1, -1, -1, -1, -1, -1, -1, 4, -1, -1, -1, 3, -1, -1
-1, 6, -1, 3, -1, 3, -1, 1, -1, 7, -1, 7, 6, 7, 4, 2, 7, 6, 9, 3, 8, 6, -1, 3, 7, 7, 3, 1, 4, 8, 3, 7, -1, 6, 5, 3, -1, 4, -1, -1
-1, 9, -1, 8, -1, -1, -1, 3, -1, 5, -1, -1, -1, -1, -1, -1, -1, -1, -1, 7, -1, -1, -1, 9, -1, -1, -1, 7, -1, -1, -1, -1, -1, 7, -1, 8, -1, 1, -1, -1
-1, 7, -1, 7, 3, 3, -1, 4, -1, 4, 9, 1, 9, 7, 3, 6, 3, 6, -1, 3, 9, 6, -1, 3, 4, 4, -1, 2, 7, 2, 8, 8, -1, 1, -1, 1, -1, 3, -1, -1
-1, 9, -1, 2, -1, -1, -1, 3, -1, 6, -1, 4, -1, 7, -1, -1, -1, -1, -1, 3, -1, 3, -1, 3, -1, 3, -1, -1, -1, 2, -1, 3, -1, -1, -1, 5, -1, 4, -1, -1
-1, 6, -1, 8, 5, 5, -1, 9, -1, 9, -1, 8, -1, 2, 4, 4, 5, 1, -1, 1, -1, 5, -1, 2, -1, 2, 4, 8, -1, 4, -1, 9, 4, 8, -1, 2, -1, 9, -1, -1
-1, 9, -1, 3, -1, 2, -1, 4, -1, 4, -1, 9, -1, 4, -1, -1, -1, -1, -1, 5, -1, -1, -1, 5, -1, -1, -1, -1, -1, 3, -1, 9, -1, -1, -1, -1, -1, 1, -1, -1
-1, 8, -1, 9, -1, 9, -1, 3, -1, 9, -1, 8, -1, 4, 9, 1, 5, 5, -1, 8, -1, 1, -1, 8, 5, 5, 3, 4, -1, 6, -1, 6, 8, 1, 2, 4, -1, 2, -1, -1
-1, 8, -1, 4, -1, 6, -1, 1, -1, 6, -1, -1, -1, 1, -1, -1, -1, -1, -1, -1, -1, 4, -1, 5, -1, 3, -1, 2, -1, -1, -1, 5, -1, -1, -1, -1, -1, -1, -1, -1
-1, 5, -1, 6, -1, 8, -1, 7, -1, 1, -1, 8, 1, 6, 3, 7, 7, 9, 3, 5, 2, 8, -1, 4, -1, 5, -1, 2, -1, 6, -1, 6, 5, 1, 8, 3, 7, 6, -1, -1
-1, -1, -1, 9, -1, 3, -1, 1, -1, 5, -1, 7, -1, 7, -1, 8, -1, -1, -1, 7, -1, 3, -1, 5, -1, 5, -1, 4, -1, 3, -1, 4, -1, 6, -1, -1, -1, -1, -1, -1
-1, 6, 4, 6, -1, 4, -1, 6, -1, 3, -1, 7, -1, 5, -1, 4, 2, 8, -1, 1, -1, 2, -1, 9, -1, 3, -1, 5, 3, 1, -1, 7, -1, 9, -1, 5, -1, 2, -1, -1
-1, 4, -1, 2, -1, 2, -1, 4, -1, 5, -1, -1, -1, 2, -1, 6, -1, -1, -1, -1, -1, 7, -1, -1, -1, 5, -1, -1, -1, 5, -1, -1, -1, -1, -1, 4, -1, 5, -1, -1
-1, 4, -1, 9, -1, 9, -1, 3, -1, 5, -1, 9, 4, 4, -1, 5, 8, 6, 9, 5, -1, 5, 9, 4, -1, 8, 2, 4, -1, 3, 3, 2, 2, 4, 4, 4, 4, 6, -1, -1
-1, 3, -1, -1, -1, -1, -1, -1, -1, 2, -1, -1, -1, 9, -1, 8, -1, -1, -1, 9, -1, 3, -1, 1, -1, -1, -1, -1, -1, -1, -1, 6, -1, -1, -1, 2, -1, -1, -1, -1
-1, 6, 2, 1, -1, 7, 8, 5, 4, 5, -1, 2, 5, 2, -1, 4, 2, 9, -1, 7, -1, 6, -1, 7, 8, 8, 9, 4, 8, 7, -1, 6, 5, 4, -1, 2, 7, 8, -1, -1
-1, 3, -1, 4, -1, -1, -1, 6, -1, 9, -1, 1, -1, 2, -1, 7, -1, -1, -1, 1, -1, 4, -1, -1, -1, 3, -1, -1, -1, 6, -1, -1, -1, -1, -1, -1, -1, 6, -1, -1
-1, 4, -1, 7, -1, 4, 5, 7, -1, 8, -1, 9, -1, 8, -1, 6, 7, 7, -1, 1, -1, 5, 4, 4, -1, 7, 5, 6, -1, 6, 9, 7, 6, 3, 5, 2, -1, 8, -1, -1
-1, 9, -1, 6, -1, -1, -1, 7, -1, 9, -1, 1, -1, 9, -1, 1, -1, 7, -1, -1, -1, 8, -1, 6, -1, 8, -1, -1, -1, -1, -1, -1, -1, 6, -1, -1, -1, -1, -1, -1
-1, 8, -1, 3, -1, 1, -1, 4, -1, 7, -1, 5, -1, 8, -1, 4, -1, 7, 7, 3, -1, 2, -1, 4, -1, 7, 4, 6, 4, 1, 7, 2, -1, 2, 7, 7, 5, 2, -1, -1
-1, -1, -1, -1, -1, 2, -1, 9, -1, 4, -1, -1, -1, 4, -1, -1, -1, -1, -1, -1, -1, 8, -1, -1, -1, 2, -1, 3, -1, -1, -1, 7, -1, 2, -1, 6, -1, 6, -1, -1
-1, 2, 3, 7, 7, 9, 5, 5, -1, 3, -1, 2, 6, 9, 6, 1, 1, 6, 8, 4, -1, 7, 8, 5, -1, 4, -1, 9, 3, 6, -1, 8, -1, 3, -1, 4, -1, 6, -1, -1
-1, 1, -1, -1, -1, 1, -1, -1, -1, 6, -1, 2, -1, 1, -1, -1, -1, -1, -1, 7, -1, 1, -1, -1, -1, 2, -1, 4, -1, -1, -1, 1, -1, 1, -1, 1, -1, -1, -1, -1
-1, 7, -1, 6, 8, 3, -1, 5, 7, 9, -1, 4, -1, 3, 8, 9, -1, 3, -1, 2, -1, 2, 4, 5, -1, 1, -1, 5, -1, 3, 2, 7, -1, 7, -1, 4, 3, 6, -1, -1
-1, -1, -1, -1, -1, 3, -1, 2, -1, 3, -1, 1, -1, 2, -1, -1, -1, 3, -1, -1, -1, 7, -1, -1, -1, -1, -1, -1, -1, -1, -1, 1, -1, -1, -1, 6, -1, 3, -1, -1
-1, 3, 8, 7, 8, 5, -1, 6, -1, 4, -1, 4, -1, 1, -1, 2, 9, 4, 8, 3, -1, 3, 2, 9, 1, 3, 5, 9, -1, 8, -1, 9, 5, 7, -1, 2, -1, 3, -1, -1
-1, 6, -1, -1, -1, 5, -1, -1, -1, 1, -1, -1, -1, 1, -1, 2, -1, -1, -1, 6, -1, 5, -1, -1, -1, -1, -1, -1, -1, 7, -1, 4, -1, 3, -1, 1, -1, -1, -1, -1
-1, 1, -1, 4, 5, 1, 7, 3, -1, 6, -1, 7, 9, 9, 1, 3, 8, 7, -1, 3, -1, 5, 7, 9, 9, 7, 6, 7, 8, 5, -1, 1, -1, 7, -1, 9, 2, 8, -1, -1
-1, -1, -1, -1, -1, -1, -1, -1, -1, -1, -1, -1, -1, -1, -1, -1, -1, -1, -1, -1, -1, -1, -1, -1, -1, -1, -1, -1, -1, -1, -1, -1, -1, -1, -1, -1, -1, -1, -1, -1
-1, -1, -1, -1, -1, -1, -1, -1, -1, -1, -1, -1, -1, -1, -1, -1, -1, -1, -1, -1, -1, -1, -1, -1, -1, -1, -1, -1, -1, -1, -1, -1, -1, -1, -1, -1, -1, -1, -1, -1